X X X X X X X X X X X X X X X X X X X X
X X X X X X X X X X X X X X X X X X X X
X X X X X X 1 - O - 2 - 7 - O X X X X X
X X X X X X - X X X - X X X - X X X X X
X X X X O - O X X X O - 4 - O X X X X X
X X X X X X X X X X - X X X X X X X X X
X X X X X X O - O - O X X X X X X X X X
X X X X X X - X X X X X X X X X X X X X
X X X X X X O X O - O - O - O X X X X X
X X X X X X - X X X - X X X X X X X X X
X X X X X X 5 - O - 6 X X X X X X X X X
X X X X X X X X X X X X X X X X X X X X
X X X X X X X X X X X X X X X X X X X X
X X X X X X X X X X X X X X X X X X X X
X X X X X X X X X X X X X X X X X X X X
X X X X X X X X X X X X X X X X X X X X