42 42 0 0 0 22 40 8 40 23 40 24 40 8 0 0 42 42
42 42 0 0 0 41 0 0 0 41 0 0 0 41 0 0 42 42
42 42 40 20 40 29 0 0 0 9 40 25 40 14 0 0 42 42
42 42 0 0 0 15 0 0 0 41 0 0 0 0 0 0 42 42
42 42 0 0 0 9 40 4 40 21 0 0 33 31 32 0 42 42
42 42 0 0 0 41 0 0 0 0 33 31 35 2 30 0 42 42
42 42 0 0 37 9 37 14 40 8 34 8 40 3 30 0 42 42
42 42 0 37 37 41 37 37 0 41 30 0 0 0 30 0 42 42
42 42 0 37 37 26 40 8 40 27 36 31 31 31 35 0 42 42